4,8,8,8,8,8,12,8,8,8,8,8,5
9,2,2,2,2,3,3,16,20,20,20,17,10
9,2,3,2,2,3,3,21,1,1,1,22,10
9,2,2,2,2,3,3,18,23,23,23,19,10
9,3,3,3,3,3,52,3,3,3,3,3,14
9,2,2,2,2,52,3,3,2,2,2,2,10
9,2,3,2,52,3,3,3,2,2,3,2,10
9,2,2,2,2,3,3,3,2,2,2,2,10
6,11,11,11,11,11,11,11,11,11,11,11,7
