4,8,8,8,8,8,12,8,8,8,8,8,5
9,16,17,2,2,3,3,3,2,2,16,17,10
9,18,19,2,2,3,52,3,2,2,18,19,10
9,2,2,2,2,52,52,52,2,2,2,2,10
9,3,3,3,52,3,52,3,52,3,3,3,10
9,2,2,2,2,3,52,3,2,2,2,2,10
9,16,17,2,2,3,52,3,2,2,16,17,10
9,18,19,2,2,3,3,3,2,2,18,19,10
6,11,11,11,11,11,15,11,11,11,11,11,7
