4,8,8,8,8,8,12,8,8,8,8,8,5
9,2,2,2,2,3,3,3,2,2,2,2,10
9,2,3,2,2,52,3,52,2,2,3,2,10
9,2,52,2,2,3,3,3,2,2,52,2,10
13,3,3,3,3,3,3,3,3,3,3,3,14
9,2,52,2,2,3,3,3,2,2,52,2,10
9,2,3,2,52,52,52,52,52,2,3,2,10
9,2,2,52,52,52,52,52,52,52,2,2,10
6,11,11,11,11,11,11,11,11,11,11,11,7
