4,8,8,8,8,8,12,8,8,8,8,8,5
9,2,2,2,2,3,3,3,2,2,2,2,10
9,2,3,2,2,3,3,3,2,2,3,2,10
9,2,2,2,52,3,3,3,52,2,2,2,10
9,3,3,3,52,3,3,3,52,3,3,3,10
9,16,20,20,17,3,52,3,16,20,20,17,10
9,21,1,1,22,3,52,3,21,1,1,22,10
9,18,23,23,19,3,3,3,18,23,23,19,10
6,11,11,11,11,11,15,11,11,11,11,11,7
