4,8,8,8,8,8,12,8,8,8,8,8,5
9,2,2,16,17,3,3,3,2,2,52,52,10
9,2,3,21,22,3,3,3,2,2,52,52,10
9,2,2,21,22,3,3,3,2,2,2,2,10
13,3,3,18,19,3,3,3,3,3,3,3,10
9,2,2,52,52,16,20,20,20,17,2,2,10
9,2,3,52,52,18,23,23,23,19,3,2,10
9,2,2,2,2,3,3,3,2,2,2,2,10
6,11,11,11,11,11,11,11,11,11,11,11,7
