4,8,8,8,8,8,8,8,8,8,8,8,5
9,2,2,2,2,3,3,3,2,2,2,2,10
9,2,3,16,17,3,3,3,16,17,3,52,10
9,2,2,18,19,3,3,3,18,19,52,52,10
9,3,3,3,3,3,3,3,3,3,3,3,14
9,2,2,16,17,3,3,3,16,17,52,52,10
9,2,3,18,19,3,3,3,18,19,3,52,10
9,2,2,2,2,3,3,3,2,2,2,2,10
6,11,11,11,11,11,11,11,11,11,11,11,7
