4,8,8,8,8,8,8,8,8,8,8,8,5
9,2,2,2,2,16,17,3,2,16,17,2,10
9,2,52,2,2,18,19,3,2,21,22,2,10
9,2,2,2,2,3,3,3,2,18,19,2,10
9,3,3,3,3,3,3,3,3,3,3,3,14
9,52,2,52,52,52,52,52,52,52,52,52,10
9,2,3,2,2,3,3,16,17,2,3,2,10
9,2,2,2,2,3,3,18,19,2,2,2,10
6,11,11,11,11,11,15,11,11,11,11,11,7
