4,8,8,8,8,8,8,8,8,8,8,8,5
9,2,18,23,19,3,3,3,2,16,20,17,10
9,2,3,2,2,3,16,17,2,21,1,22,10
9,2,2,52,17,3,52,52,2,18,23,19,10
13,3,3,52,22,3,3,52,3,3,52,3,14
9,2,2,52,22,3,3,52,52,2,52,2,10
9,2,3,52,22,3,3,3,52,2,52,2,10
9,2,2,52,19,3,3,3,52,2,2,2,10
6,11,11,11,11,11,15,11,11,11,11,11,7
