4,8,8,8,8,8,8,8,8,8,8,8,5
9,2,2,2,2,16,20,17,2,2,2,2,10
9,2,3,2,2,21,1,22,2,2,3,2,10
9,2,16,17,2,21,1,22,2,16,17,2,10
13,3,21,22,3,21,1,22,3,21,22,3,14
9,2,21,22,2,18,23,19,2,21,22,2,10
9,2,21,22,2,3,3,3,2,21,22,2,10
9,2,18,19,2,3,3,3,2,18,19,2,10
6,11,11,11,11,11,11,11,11,11,11,11,7
