4,8,8,8,8,8,8,8,8,8,8,8,5
9,2,2,2,2,3,3,3,2,2,2,2,10
9,2,52,2,16,20,20,20,17,2,52,2,10
9,2,2,2,21,1,52,1,22,2,2,2,10
13,3,2,3,21,52,52,52,22,3,2,3,14
9,2,2,2,21,1,52,1,22,2,2,2,10
9,2,52,3,18,23,23,23,19,3,52,2,10
9,2,2,2,2,3,3,3,2,2,2,2,10
6,11,11,11,11,11,11,11,11,11,11,11,7
