4,8,8,8,8,8,8,8,8,8,8,8,5
9,2,2,2,2,3,3,3,2,2,2,52,10
9,2,16,17,2,16,17,3,16,17,3,52,10
9,2,18,19,2,18,19,3,18,19,2,52,10
13,3,3,3,3,3,3,3,3,3,3,52,10
9,2,16,17,2,16,17,3,16,17,2,52,10
9,2,18,19,2,18,19,3,18,19,3,52,10
9,2,2,2,2,3,3,3,2,2,2,52,10
6,11,11,11,11,11,15,11,11,11,11,11,7
