4,8,8,8,8,8,8,8,8,8,8,8,5
9,2,2,2,2,3,3,3,2,2,2,2,10
9,2,16,20,20,20,17,52,2,2,3,2,10
9,2,18,23,23,23,19,52,2,2,2,2,10
13,3,3,3,3,3,3,3,3,3,3,3,10
9,2,16,20,20,20,17,52,2,2,2,2,10
9,2,18,23,23,23,19,52,2,2,3,2,10
9,2,2,2,2,3,3,3,2,2,2,2,10
6,11,11,11,11,11,11,11,11,11,11,11,7
