4,8,8,8,8,8,39,8,8,8,8,8,5
9,2,2,2,2,3,3,3,2,2,2,2,10
9,2,3,52,52,3,3,3,52,52,3,2,10
9,2,2,2,2,3,3,3,2,2,2,2,10
9,3,3,3,3,3,3,3,3,3,3,3,10
9,2,2,52,52,3,3,3,52,52,2,2,10
9,2,3,2,2,3,3,3,2,2,3,2,10
9,2,2,2,2,3,3,3,2,2,2,2,10
6,11,11,11,11,11,15,11,11,11,11,11,7
