1,1,1,1,1,1,1,1,1,1,1,1,1
1,1,1,1,1,1,1,1,1,1,1,1,1
1,1,1,1,1,1,1,1,1,1,1,1,1
4,8,8,8,8,8,8,8,8,8,8,8,5
9,2,2,2,2,3,3,3,2,2,2,2,10
9,2,55,3,55,3,3,3,55,3,55,2,10
9,2,56,3,56,3,3,3,56,3,56,2,10
9,2,2,2,2,3,3,3,2,2,2,2,10
6,11,11,11,11,11,15,11,11,11,11,11,7
